#################
#...............$
$@..............$
$...............$
#...............$
########$##$#####