#############$##
#............@.#
#.##########...#
#.##########...#
#..............#
#.##########...#
#.##########...#
#..............#
#.##########...#
#.##########...#
#..............#
################