4hhhhhhhhHhh
42].#.#.#..1
42#........1
42..#.#.#..1
42.........1
42..###.#..1
42.........1
42..#.#.#..1
47.........1
42..#.#.#..1
42..#...@..1
42.........1
