hhhhhhhhHhh
1].#.#.#..1
1.........1
1..#.#.#..1
1.........1
1..#.#.#..1
1.........1
1..#.#.#..1
1.......@.1
1..#.#.#..1
1..#......1
1.........1
