hhhhhhhhHhh
1..#.#.#..1
1.........1
1..#.#@#..1
1..]......1
1..#.#.#..1
1.........1
1..#.#.#..1
1.........1
1..#.#.#..1
1.........1
11111111111
