#######$$#######
$..............$
$@.............$
$..............$
$..............$
###########$####