###$###
#..@..#
#.....#
#.....#
#.....#
#.....#
#.....#
#.....#
#.....#
#.....#
#.....#
#######