################
$..............#
$@.............$
$..............$
$..............#
####$####$######