####$####
#...@...#
#.......#
#.......#
#.......#
#.......#
#.......#
#.......#
#.......#
#.......#
#.......#
#########