##$#############
#.@............#
#.##########...#
#.##########...#
#..............#
#.##########...#
#.##########...#
#..............#
#.##########...#
#.##########...#
#..............#
################