##########
#........#
$@.......#
$........#
#........#
######...#
######...#
######...#
#######$##